R 1280 720

NO ./wood.xpm
SO ./almaz.xpm
WE ./obsidian.xpm
EA ./1.xpm
S ./ter.xpm

F 112  ,  191  ,  34
C 229  ,  244  ,  255

1111111111111111111111111111111111111111
1001000001000000000000000000002000000001
1000100000011111000000000000002220000001
100000100001   1000000000000000000000001
102000000001   1000000000000000000000S01
100100000011   1000000000000000000000001
1000000000011111000000010000000000000001
1000100000000000000000000000000000000001
1111111111111111111111111111111111111111